#############
#-----o-----#
#-----------#
#-----------#
#-----------#
#------1---x#
#op----2--xo#
#------3---x#
#-4---------#
#-----------#
#-----------#
#-x---o-----#
#############