#############
#ooo------xo#
#----------o#
#-----------#
#o---ooo----#
#o----------#
#xx4-3-2-1-p#
#o----------#
#o---ooo----#
#x----------#
#----------o#
#ooo-------o#
#############