#############
#oooo-p-oooo#
#ooo-----ooo#
#oo---o---oo#
#o-1--o--2-o#
#o---------o#
#o-3--o--4-o#
#ooo--o--ooo#
#oooo---oooo#
#ooo-----ooo#
#ox-------xo#
#o---x-x---o#
#############