#############
#x---------x#
#-----------#
#-----------#
#--1-----2--#
#-----------#
#-----p-----#
#-----------#
#--3-----4--#
#-----------#
#-----------#
#x---------x#
#############