#############
#-----------#
#--ooo-ooo--#
#-o---o---o-#
#o----x----o#
#o---1p2---o#
#o---------o#
#-o---3---o-#
#--ox----o--#
#---ox4-o---#
#----oxo----#
#-----o-----#
#############