#############
#x----------#
#-o-------o-#
#----------x#
#-----o-----#
#---1---2---#
#--o--p--o--#
#---3---4---#
#-----o-----#
#----------x#
#-o-------o-#
#x----------#
#############