#############
#oo--o-o--oo#
#ox-------xo#
#-----------#
#-----o-----#
#o---1-2---o#
#---o-p-o---#
#o---3-4---o#
#-----o-----#
#-----------#
#ox-------xo#
#oo--o-o--oo#
#############